{u'ATM': u'CAJERO autom\xe1tico',
 u'Acai House': u'Acai Casa',
 u'Accessories Store': u'Tienda De Accesorios',
 u'Acehnese Restaurant': u'De Aceh Restaurante',
 u'Acupuncturist': u'Acupunturista',
 u'Adult Boutique': u'Adultos Boutique',
 u'Advertising Agency': u'Agencia De Publicidad',
 u'Afghan Restaurant': u'Afgano Restaurante',
 u'African Restaurant': u'African Restaurant',
 u'Airport': u'Aeropuerto',
 u'Airport Food Court': u'Aeropuerto Patio De Comidas',
 u'Airport Gate': u'Puerta De Embarque Del Aeropuerto',
 u'Airport Lounge': u'Sala Vip En El Aeropuerto',
 u'Airport Terminal': u'Terminal Del Aeropuerto',
 u'Airport Tram': u'Aeropuerto De Tranv\xeda',
 u'Alternative Healer': u'Alternativa Sanador',
 u'American Restaurant': u'Restaurante Americano',
 u'Anhui Restaurant': u'Anhui Restaurante',
 u'Animal Shelter': u'Refugio De Animales',
 u'Antique Shop': u'Tienda De Antig\xfcedades',
 u'Apres Ski Bar': u'Apres Ski Bar',
 u'Aquarium': u'Acuario',
 u'Arcade': u'Arcade',
 u'Arepa Restaurant': u'Arepa De Restaurante',
 u'Argentinian Restaurant': u'Restaurante Argentino',
 u'Art Gallery': u'Galer\xeda De Arte',
 u'Art Museum': u'Museo De Arte',
 u'Arts & Crafts Store': u'Artes Y Manualidades',
 u'Arts & Entertainment': u'Arte Y Entretenimiento',
 u'Asian Restaurant': u'Restaurante Asi\xe1tico',
 u'Assisted Living': u'De Vida Asistida',
 u'Astrologer': u'Astr\xf3logo',
 u'Athletics & Sports': u'Atletismo Y Deportes',
 u'Auditorium': u'Auditorio',
 u'Australian Restaurant': u'Australia Restaurante',
 u'Austrian Restaurant': u'Austria Restaurante',
 u'Auto Garage': u'Auto De Garaje',
 u'Automotive Shop': u'Tienda Automotriz',
 u'BBQ Joint': u'BARBACOA Conjunta',
 u'Baby Store': u'Tienda De Beb\xe9',
 u'Badminton Court': u'Cancha De B\xe1dminton',
 u'Bagel Shop': u'"Bagel Shop"',
 u'Baiano Restaurant': u'Baiano Restaurante',
 u'Bakery': u'Panader\xeda',
 u'Balinese Restaurant': u'Balinesa Restaurante',
 u'Bank': u'Banco',
 u'Bar': u'Bar',
 u'Baseball Field': u'Campo De B\xe9isbol',
 u'Baseball Stadium': u'El Estadio De B\xe9isbol',
 u'Basketball Court': u'Cancha De Baloncesto',
 u'Basketball Stadium': u'Estadio De Baloncesto',
 u'Bath House': u'Ba\xf1o De La Casa',
 u'Bathing Area': u'Zona De Ba\xf1o',
 u'Beach': u'Playa',
 u'Beach Bar': u'Bar De Playa',
 u'Bed & Breakfast': u'Cama Y Desayuno',
 u'Beer Garden': u'Jard\xedn De La Cerveza',
 u'Beer Store': u'Tienda De Cerveza',
 u'Beijing Restaurant': u'Beijing Restaurante',
 u'Belarusian Restaurant': u'Bielorruso Restaurante',
 u'Belgian Restaurant': u'Restaurante Belga',
 u'Betawinese Restaurant': u'Betawinese Restaurante',
 u'Betting Shop': u'Tienda De Apuestas',
 u'Big Box Store': u'Gran Caja De Tienda',
 u'Bike Rental / Bike Share': u'Alquiler De Bicicletas / Bicicleta Compartir',
 u'Bike Shop': u'Tienda De Bicicletas',
 u'Bistro': u'Bistro',
 u'Blini House': u'Blinis De La Casa',
 u'Board Shop': u'La Junta De La Tienda',
 u'Boarding House': u'Casa De Embarque',
 u'Boat or Ferry': u'En barco o en Ferry',
 u'Bookstore': u'Librer\xeda',
 u'Border Crossing': u'El Cruce De La Frontera',
 u'Borek Place': u'Borek Lugar',
 u'Botanical Garden': u'Jard\xedn Bot\xe1nico',
 u'Boutique': u'Boutique',
 u'Bowling Alley': u'Bolera',
 u'Bowling Green': u'De Bowling Green',
 u'Boxing Gym': u'Gimnasio De Boxeo',
 u'Brazilian Restaurant': u'Restaurante Brasile\xf1o',
 u'Breakfast Spot': u'Desayuno Irregular',
 u'Brewery': u'Cervecer\xeda',
 u'Bridal Shop': u'Tienda Nupcial',
 u'Bridge': u'Puente',
 u'Bubble Tea Shop': u'Bubble Tea Shop',
 u'Buddhist Temple': u'Templo Budista',
 u'Buffet': u'Buffet',
 u'Building': u'Edificio',
 u'Burger Joint': u'Restaurante De Hamburguesas',
 u'Burrito Place': u'Burrito Lugar',
 u'Bus Line': u'La L\xednea De Autob\xfas',
 u'Bus Station': u'Estaci\xf3n De Autobuses',
 u'Bus Stop': u'Parada De Autob\xfas',
 u'Butcher': u'Carnicero',
 u'Cable Car': u'Telef\xe9rico',
 u'Caf\xe9': u'Cafeter\xeda',
 u'Cajun / Creole Restaurant': u'Cajun / Restaurante Criollo',
 u'Cambodian Restaurant': u'Camboya Restaurante',
 u'Camera Store': u'Tienda De C\xe1maras',
 u'Campaign Office': u'Oficina De La Campa\xf1a',
 u'Campground': u'Camping',
 u'Candy Store': u'Tienda De Dulces',
 u'Cantonese Restaurant': u'Restaurante Canton\xe9s',
 u'Capitol Building': u'Edificio Del Capitolio',
 u'Car Dealership': u'Coche De Concesionario',
 u'Car Wash': u'Lavado De Coches',
 u'Caribbean Restaurant': u'Restaurante Caribe\xf1o',
 u'Carpet Store': u'Tienda De Alfombras',
 u'Casino': u'Casino',
 u'Castle': u'Castillo',
 u'Caucasian Restaurant': u'Cauc\xe1sico Restaurante',
 u'Cemetery': u'Cementerio',
 u'Central Brazilian Restaurant': u'Central Brasile\xf1o Restaurante',
 u'Champagne Bar': u'Bar De Champ\xe1n',
 u'Check Cashing Service': u'Servicio De Cambio De Cheques',
 u'Cheese Shop': u'Tienda De Quesos',
 u'Chinese Aristocrat Restaurant': u'Chino Arist\xf3crata Restaurante',
 u'Chinese Breakfast Place': u'Desayuno Chino, Lugar',
 u'Chinese Restaurant': u'Restaurante Chino',
 u'Chiropractor': u'Quiropr\xe1ctico',
 u'Chocolate Shop': u'Tienda De Chocolate',
 u'Christmas Market': u'Mercado De Navidad',
 u'Church': u'Iglesia',
 u'Churrascaria': u'Churrascaria',
 u'Cigkofte Place': u'Cigkofte Lugar',
 u'Circus': u'Circo',
 u'Circus School': u'Escuela De Circo',
 u'City': u'Ciudad',
 u'City Hall': u'Ayuntamiento',
 u'Climbing Gym': u'Gimnasio De Escalada',
 u'Clothing Store': u'Tienda De Ropa',
 u'Club House': u'Casa Club',
 u'Cocktail Bar': u'Bar De C\xf3cteles',
 u'College & University': u'College Y La Universidad',
 u'College Academic Building': u'Edificio Acad\xe9mico De La Universidad',
 u'College Administrative Building': u'Colegio Edificio Administrativo',
 u'College Arts Building': u'La Universidad De Las Artes De Construcci\xf3n',
 u'College Auditorium': u'Auditorio De Colegio',
 u'College Baseball Diamond': u'La Universidad Diamante De B\xe9isbol',
 u'College Basketball Court': u'Baloncesto De La Universidad De La Corte',
 u'College Bookstore': u'Librer\xeda De La Universidad',
 u'College Cafeteria': u'Cafeter\xeda De La Universidad',
 u'College Classroom': u'Clase En La Universidad',
 u'College Communications Building': u'La Universidad De Comunicaciones De La Construcci\xf3n',
 u'College Cricket Pitch': u'Colegio Campo De Cricket',
 u'College Engineering Building': u'Colegio De Ingenier\xeda De La Construcci\xf3n',
 u'College Football Field': u'Campo De F\xfatbol De La Universidad',
 u'College Gym': u'Colegio Gimnasio',
 u'College History Building': u'Colegio De Historia De La Construcci\xf3n',
 u'College Hockey Rink': u'La Universidad De Hockey Sobre Patines',
 u'College Lab': u'Laboratorio Universitario',
 u'College Library': u'Biblioteca Universitaria',
 u'College Math Building': u'Colegio De Matem\xe1ticas De La Construcci\xf3n',
 u'College Quad': u'La Universidad Quad',
 u'College Rec Center': u'La Universidad Rec Center',
 u'College Residence Hall': u'College Residence Hall',
 u'College Science Building': u'La Universidad De Ciencias De La Construcci\xf3n',
 u'College Soccer Field': u'Colegio Campo De F\xfatbol',
 u'College Stadium': u'Estadio Universitario',
 u'College Technology Building': u'La Universidad De La Tecnolog\xeda De La Construcci\xf3n',
 u'College Tennis Court': u'La Universidad Pista De Tenis',
 u'College Theater': u'En El Colegio De Teatro',
 u'College Track': u'La Universidad De La Pista',
 u'Comedy Club': u'Club De La Comedia',
 u'Comfort Food Restaurant': u'La Comodidad De Un Restaurante De Comida',
 u'Comic Shop': u'Tienda De C\xf3mics',
 u'Community Center': u'Centro De La Comunidad',
 u'Community College': u'Universidad De Comunidad',
 u'Concert Hall': u'Sala De Conciertos',
 u'Conference': u'Conferencia',
 u'Conference Room': u'Sala De Conferencias',
 u'Convenience Store': u'Tienda De Conveniencia',
 u'Convention': u'Convenci\xf3n',
 u'Convention Center': u'Centro De Convenciones',
 u'Cosmetics Shop': u'Los Cosm\xe9ticos De La Tienda',
 u'Costume Shop': u'Tienda De Disfraces',
 u'Country': u'Pa\xeds',
 u'Country Dance Club': u'El Pa\xeds Club De Baile',
 u'County': u'Condado',
 u'Courthouse': u'Palacio de justicia',
 u'Coworking Space': u'Espacio De Coworking',
 u'Credit Union': u'Cooperativa De Cr\xe9dito',
 u'Creperie': u'Creper\xeda',
 u'Cricket Ground': u'Cricket Ground',
 u'Cuban Restaurant': u'Restaurante Cubano',
 u'Cultural Center': u'Centro Cultural',
 u'Cupcake Shop': u'Tienda De Cupcake',
 u'Cycle Studio': u'Ciclo De Estudio',
 u'Czech Restaurant': u'Restaurante Checo',
 u'Dance Studio': u'Estudio De Danza',
 u'Daycare': u'La guarder\xeda',
 u'Deli / Bodega': u'Deli / Bodega',
 u"Dentist's Office": u'La Oficina del dentista',
 u'Department Store': u'Departamento De Almac\xe9n',
 u'Design Studio': u'Estudio De Dise\xf1o',
 u'Dessert Shop': u'Postre Tienda',
 u'Dim Sum Restaurant': u'Dim Sum De Restaurante',
 u'Diner': u'Diner',
 u'Disc Golf': u'Golf De Disco',
 u'Discount Store': u'Tienda De Descuento',
 u'Distillery': u'La destiler\xeda',
 u'Distribution Center': u'Centro De Distribuci\xf3n',
 u'Dive Bar': u'Bar De Buceo',
 u'Dive Shop': u'Tienda De Buceo',
 u'Dive Spot': u'Sitio De Buceo',
 u"Doctor's Office": u'Consultorio m\xe9dico',
 u'Dog Run': u'Carrera De Perros',
 u'Doner Restaurant': u'Restaurante Doner',
 u'Dongbei Restaurant': u'Dongbei Restaurante',
 u'Donut Shop': u'Tienda De Donuts',
 u'Driving School': u'Escuela De Conducci\xf3n',
 u'Drugstore / Pharmacy': u'Farmacia / Farmacia',
 u'Dry Cleaner': u'Tintorer\xeda',
 u'Dumpling Restaurant': u'Ravioles Restaurante',
 u'EV Charging Station': u'EV Estaci\xf3n de Carga',
 u'Eastern European Restaurant': u'Europa Oriental Restaurante',
 u'Electronics Store': u'Tienda De Electr\xf3nica',
 u'Elementary School': u'La Escuela Primaria',
 u'Embassy / Consulate': u'Embajada / Consulado De',
 u'Emergency Room': u'Sala De Emergencia',
 u'Empada House': u'Empada De La Casa',
 u'Empanada Restaurant': u'Empanada Restaurante',
 u'English Restaurant': u'Restaurante Ingl\xe9s',
 u'Ethiopian Restaurant': u'Et\xedope Restaurante',
 u'Event': u'Evento',
 u'Event Space': u'Espacio Para Eventos',
 u'Eye Doctor': u'Doctor De Los Ojos',
 u'Fabric Shop': u'La Tela De La Tienda',
 u'Factory': u'F\xe1brica',
 u'Fair': u'Feria',
 u'Falafel Restaurant': u'Falafel De Restaurante',
 u'Farm': u'Granja',
 u'Farmers Market': u'Mercado De Los Agricultores',
 u'Fast Food Restaurant': u'Restaurante De Comida R\xe1pida',
 u'Festival': u'Festival',
 u'Field': u'Campo',
 u'Filipino Restaurant': u'Filipino Restaurante',
 u'Financial or Legal Service': u'Legales o financieros Servicio de',
 u'Fire Station': u'Estaci\xf3n De Bomberos',
 u'Fireworks Store': u'Los Fuegos Artificiales De La Tienda',
 u'Fish & Chips Shop': u'Fish & Chips',
 u'Fish Market': u'Mercado De Pescado',
 u'Fishing Spot': u'Lugar De Pesca',
 u'Fishing Store': u'Tienda De Pesca',
 u'Flea Market': u'Mercado De Pulgas',
 u'Flight School': u'Escuela De Vuelo',
 u'Flower Shop': u'Tienda De Flores',
 u'Fondue Restaurant': u'Fondue De Restaurante',
 u'Food': u'Alimentos',
 u'Food & Drink Shop': u'Alimentos Y Bebidas De La Tienda',
 u'Food Court': u'Patio De Comidas',
 u'Food Truck': u'Camiones De Venta De Alimentos',
 u'Forest': u'Bosque',
 u'Frame Store': u'Tienda De Marcos',
 u'Fraternity House': u'Casa De La Fraternidad',
 u'French Restaurant': u'Restaurante Franc\xe9s',
 u'Fried Chicken Joint': u'Pollo Frito Conjuntas',
 u'Frozen Yogurt': u'Helado De Yogurt',
 u'Fruit & Vegetable Store': u'Frutas Y Verduras De La Tienda',
 u'Fujian Restaurant': u'Fujian Restaurante',
 u'Funeral Home': u'Funeraria',
 u'Furniture / Home Store': u'Muebles De Hogar / Tienda',
 u'Gaming Cafe': u'Juego De Cafe',
 u'Garden': u'Jard\xedn',
 u'Garden Center': u'Centro De Jardiner\xeda',
 u'Gas Station / Garage': u'La Estaci\xf3n De Gas / Garaje',
 u'Gastropub': u'Gastropub',
 u'Gay Bar': u'Bar Gay',
 u'General College & University': u'General De Educaci\xf3n Y La Universidad',
 u'General Entertainment': u'Entretenimiento General',
 u'General Travel': u'General De Viajes',
 u'German Restaurant': u'Restaurante Alem\xe1n',
 u'Gift Shop': u'Tienda De Regalos',
 u'Gluten-free Restaurant': u'Libre de Gluten Restaurante',
 u'Go Kart Track': u'Pista De Karts',
 u'Goiano Restaurant': u'Goiano Restaurante',
 u'Golf Course': u'Campo De Golf',
 u'Gourmet Shop': u'Tienda Gourmet',
 u'Government Building': u'Edificio Del Gobierno',
 u'Gozleme Place': u'Gozleme Lugar',
 u'Greek Restaurant': u'Restaurante Griego',
 u'Grocery Store': u'Tienda De Comestibles',
 u'Guizhou Restaurant': u'Guizhou Restaurante',
 u'Gun Range': u'Pistola De Gama',
 u'Gun Shop': u'Tienda De Armas',
 u'Gym': u'Gimnasio',
 u'Gym / Fitness Center': u'Gimnasio / Centro De Fitness',
 u'Gym Pool': u'Gimnasio Piscina',
 u'Gymnastics Gym': u'Gimnasio De Gimnasia',
 u'Hainan Restaurant': u'Hainan Restaurante',
 u'Hakka Restaurant': u'Restaurante Hakka',
 u'Halal Restaurant': u'Restaurante Halal',
 u'Harbor / Marina': u'Puerto / Puerto Deportivo',
 u'Hardware Store': u'Tienda De Hardware',
 u'Hawaiian Restaurant': u'Restaurante Hawaiano',
 u'Health Food Store': u'Tienda De Alimentos Saludables',
 u'Henan Restaurant': u'Henan Restaurante',
 u'Herbs & Spices Store': u'Hierbas Y Especias De La Tienda',
 u'Himalayan Restaurant': u'Himalaya Restaurante',
 u'Hindu Temple': u'Templo Hind\xfa',
 u'Historic Site': u'Sitio Hist\xf3rico',
 u'History Museum': u'Museo De Historia',
 u'Hobby Shop': u'Tienda De Modelismo',
 u'Hockey Arena': u'El Estadio De Hockey',
 u'Hockey Field': u'Hockey De Campo',
 u'Home (private)': u'Hogar (privado)',
 u'Home Cooking Restaurant': u'Restaurante De Comida Casera',
 u'Hong Kong Restaurant': u'Hong Kong Restaurante',
 u'Hookah Bar': u'Hookah Bar',
 u'Hospital': u'Hospital',
 u'Hostel': u'Albergue',
 u'Hot Dog Joint': u'Perro Caliente Conjuntas',
 u'Hot Spring': u'Primavera Caliente',
 u'Hotel': u'Hotel',
 u'Hotel Bar': u'Bar Del Hotel',
 u'Hotel Pool': u'La Piscina Del Hotel',
 u'Hotpot Restaurant': u'Estofado De Restaurante',
 u'Housing Development': u'El Desarrollo De La Vivienda',
 u'Huaiyang Restaurant': u'Huaiyang Restaurante',
 u'Hubei Restaurant': u'Hubei Restaurante',
 u'Hunan Restaurant': u'Hunan Restaurant',
 u'Hungarian Restaurant': u'Restaurante H\xfangaro',
 u'Hunting Supply': u'La Caza De La Oferta',
 u'IT Services': u'Servicios de TI',
 u'Ice Cream Shop': u'Tienda De Helados',
 u'Imperial Restaurant': u'Restaurante Imperial',
 u'Indian Restaurant': u'Restaurante Indio',
 u'Indie Movie Theater': u'Cine Independiente',
 u'Indie Theater': u'Indie Teatro',
 u'Indonesian Restaurant': u'Indonesia Restaurante',
 u'Internet Cafe': u'Caf\xe9 Internet',
 u'Intersection': u'Intersecci\xf3n',
 u'Irish Pub': u'Pub Irland\xe9s',
 u'Island': u'Isla',
 u'Italian Restaurant': u'Restaurante Italiano',
 u'Japanese Restaurant': u'Restaurante Japon\xe9s',
 u'Javanese Restaurant': u'Javan\xe9s Restaurante',
 u'Jazz Club': u'Club De Jazz',
 u'Jewelry Store': u'Tienda De Joyas',
 u'Jewish Restaurant': u'Jud\xedo Restaurante',
 u'Jiangsu Restaurant': u'Jiangsu Restaurante',
 u'Jiangxi Restaurant': u'Jiangxi Restaurante',
 u'Juice Bar': u'Bar De Jugos',
 u'Karaoke Bar': u'Bar De Karaoke',
 u'Kebab Restaurant': u'Restaurante De Kebab',
 u'Kids Store': u'Los Ni\xf1os De La Tienda',
 u'Knitting Store': u'Tejido De Punto De La Tienda',
 u'Kofte Place': u'Kofte Lugar',
 u'Kokore\xe7 Restaurant': u'Kokore\xe7 Restaurante',
 u'Korean Restaurant': u'Restaurante Coreano',
 u'Kosher Restaurant': u'Restaurante Kosher',
 u'Laboratory': u'Laboratorio',
 u'Lake': u'Lago',
 u'Language School': u'Escuela De Idiomas',
 u'Laser Tag': u'Laser Tag',
 u'Latin American Restaurant': u'Am\xe9rica Latina Restaurante',
 u'Laundromat': u'Lavander\xeda',
 u'Laundry Service': u'Servicio De Lavander\xeda',
 u'Law School': u'Escuela De Derecho',
 u'Lawyer': u'Abogado',
 u'Leather Goods Store': u'Tienda De Art\xedculos De Cuero',
 u'Library': u'Biblioteca',
 u'Light Rail': u'Tren Ligero',
 u'Lighthouse': u'Faro',
 u'Lingerie Store': u'La Tienda De Lencer\xeda',
 u'Liquor Store': u'Tienda De Licores',
 u'Locksmith': u'Cerrajero',
 u'Lottery Retailer': u'Punto De Venta De Loter\xeda',
 u'Lounge': u'Sal\xf3n',
 u'Luggage Store': u'Almac\xe9n De Equipaje',
 u'Mac & Cheese Joint': u'Mac & Cheese Conjuntas',
 u'Macanese Restaurant': u'Macanese Restaurante',
 u'Malaysian Restaurant': u'Malasia Restaurante',
 u'Mall': u'Centro comercial',
 u'Manadonese Restaurant': u'Manadonese Restaurante',
 u'Manchu Restaurant': u'Manchu Restaurante',
 u'Manti Place': u'Manti Lugar',
 u'Marijuana Dispensary': u'Dispensario De Marihuana',
 u'Market': u'Mercado',
 u'Martial Arts Dojo': u'Dojo De Artes Marciales',
 u'Massage Studio': u'Estudio De Masajes A',
 u'Mattress Store': u'Tienda De Colchones',
 u'Meatball Place': u'Alb\xf3ndigas Lugar',
 u'Medical Center': u'Centro M\xe9dico',
 u'Medical School': u'Escuela De Medicina',
 u'Mediterranean Restaurant': u'Restaurante Mediterr\xe1neo',
 u'Meeting Room': u'Sala De Reuniones',
 u"Men's Store": u'Los hombres de la Tienda',
 u'Mental Health Office': u'La Salud Mental De La Oficina',
 u'Mexican Restaurant': u'Restaurante Mexicano',
 u'Meyhane': u'Meyhane',
 u'Middle Eastern Restaurant': u'Restaurante De Oriente',
 u'Middle School': u'Escuela Secundaria',
 u'Military Base': u'Base Militar',
 u'Mineiro Restaurant': u'Mineiro Restaurante',
 u'Mini Golf': u'Mini Golf',
 u'Miscellaneous Shop': u'Miscel\xe1nea Tienda',
 u'Mobile Phone Shop': u'Tienda De Telefon\xeda M\xf3vil',
 u'Modern European Restaurant': u'Europeo Moderno Restaurante',
 u'Molecular Gastronomy Restaurant': u'La Gastronom\xeda Molecular Restaurante',
 u'Monastery': u'Monasterio',
 u'Mongolian Restaurant': u'Restaurante Mongol',
 u'Monument / Landmark': u'Monument / Monumento',
 u'Moroccan Restaurant': u'Restaurante Marroqu\xed',
 u'Mosque': u'Mezquita',
 u'Motel': u'Motel',
 u'Motorcycle Shop': u'Tienda De Motos',
 u'Mountain': u'Monta\xf1a',
 u'Movie Theater': u'Cine',
 u'Moving Target': u'Objetivo En Movimiento',
 u'Multiplex': u'Multiplex',
 u'Museum': u'Museo',
 u'Music Festival': u'Festival De M\xfasica',
 u'Music School': u'Escuela De M\xfasica',
 u'Music Store': u'Tienda De M\xfasica',
 u'Music Venue': u'Local De M\xfasica En',
 u'Nail Salon': u'Sal\xf3n De U\xf1as',
 u'National Park': u'Parque Nacional',
 u'Nature Preserve': u'Para Preservar La Naturaleza',
 u'Neighborhood': u'Barrio',
 u'New American Restaurant': u'Nuevo Restaurante Americano',
 u'Newsstand': u'Puesto de peri\xf3dicos',
 u'Nightclub': u'Discoteca',
 u'Nightlife Spot': u'La Vida Nocturna Irregular',
 u'Non-Profit': u'Sin Fines De Lucro',
 u'Northeastern Brazilian Restaurant': u'Noreste Brasile\xf1o Restaurante',
 u'Northern Brazilian Restaurant': u'Norte Restaurante Brasile\xf1o',
 u'Nudist Beach': u'Playa Nudista',
 u'Nursery School': u'Escuela De Enfermer\xeda',
 u'Office': u'Oficina',
 u'Opera House': u'La Casa De La \xd3pera',
 u'Optical Shop': u'Tienda \xd3ptica',
 u'Organic Grocery': u'Alimentos Org\xe1nicos',
 u'Other Event': u'Otro Evento',
 u'Other Great Outdoors': u'Otros Grandes Al Aire Libre',
 u'Other Nightlife': u'Vida Nocturna',
 u'Other Repair Shop': u'Otro Taller De Reparaci\xf3n',
 u'Outdoor Sculpture': u'Escultura Al Aire Libre',
 u'Outdoor Supply Store': u'Al Aire Libre, Tienda De Alimentaci\xf3n',
 u'Outdoors & Recreation': u'Al Aire Libre Y Recreaci\xf3n',
 u'Outlet Store': u'Tienda Outlet',
 u'Padangnese Restaurant': u'Padangnese Restaurante',
 u'Paella Restaurant': u'Paella Restaurante',
 u'Paintball Field': u'Campo De Paintball',
 u'Pakistani Restaurant': u'Restaurante Paquistan\xed',
 u'Palace': u'Palacio',
 u'Paper / Office Supplies Store': u'Papel / Suministros De Oficina Tienda',
 u'Parade': u'Desfile',
 u'Park': u'Parque',
 u'Parking': u'Aparcamiento',
 u'Pastelaria': u'Pastelaria',
 u'Pawn Shop': u'Pawn Shop',
 u'Pedestrian Plaza': u'Plaza Peatonal',
 u'Peking Duck Restaurant': u'El Pato De Pek\xedn Restaurante',
 u'Pelmeni House': u'Los Pelmeni Casa',
 u'Performing Arts Venue': u'De Artes Esc\xe9nicas',
 u'Perfume Shop': u'Tienda De Perfumes',
 u'Persian Restaurant': u'Persa Restaurante',
 u'Peruvian Restaurant': u'Restaurante Peruano',
 u'Pet Service': u'Servicio De Mascotas',
 u'Pet Store': u'Tienda De Mascotas',
 u'Photography Lab': u'La Fotograf\xeda De Laboratorio',
 u'Piano Bar': u'Piano Bar',
 u'Pide Place': u'Pide Lugar',
 u'Pie Shop': u'El Pastel De La Tienda',
 u'Pier': u'Pier',
 u'Piercing Parlor': u'Sal\xf3n De Perforaci\xf3n',
 u'Pizza Place': u'Lugar De Pizza',
 u'Plane': u'Plano',
 u'Planetarium': u'Planetario',
 u'Platform': u'Plataforma',
 u'Playground': u'Patio de juegos',
 u'Plaza': u'Plaza',
 u'Police Station': u'Estaci\xf3n De Polic\xeda',
 u'Polish Restaurant': u'Restaurante Polaco',
 u'Pool': u'Piscina',
 u'Pool Hall': u'Sal\xf3n De Billar',
 u'Pop-Up Shop': u'Tienda Pop-Up',
 u'Portuguese Restaurant': u'Restaurante Portugu\xe9s',
 u'Post Office': u'Oficina De Correos',
 u'Prayer Room': u'Sala De Oraci\xf3n',
 u'Preschool': u'Preescolar',
 u'Print Shop': u'Tienda De Impresi\xf3n',
 u'Prison': u'Prisi\xf3n',
 u'Private School': u'Escuela Privada',
 u'Professional & Other Places': u'Profesionales Y Otros Lugares',
 u'Pub': u'Pub',
 u'Public Art': u'El Arte P\xfablico',
 u'RV Park': u'Parque de RV',
 u'Racetrack': u'Pista de carreras',
 u'Radio Station': u'Estaci\xf3n De Radio',
 u'Rafting': u'Rafting',
 u'Ramen / Noodle House': u'Ramen / Noodle House',
 u'Real Estate Office': u'La Oficina De Bienes Ra\xedces',
 u'Record Shop': u'Tienda De Discos',
 u'Recording Studio': u'Estudio De Grabaci\xf3n',
 u'Recreation Center': u'Centro De Recreaci\xf3n',
 u'Recruiting Agency': u'Agencia De Reclutamiento',
 u'Recycling Facility': u'Planta De Reciclaje',
 u'Religious School': u'Religiosos De La Escuela',
 u'Rental Car Location': u'Ubicaci\xf3n De Coches De Alquiler',
 u'Residence': u'Residencia',
 u'Residential Building (Apartment / Condo)': u'Edificio Residencial (Apartamento / Condo)',
 u'Resort': u'Resort',
 u'Rest Area': u'\xc1rea De Descanso',
 u'Restaurant': u'Restaurante',
 u'River': u'R\xedo',
 u'Road': u'Carretera',
 u'Rock Climbing Spot': u'Escalada En Roca Irregular',
 u'Rock Club': u'Rock Club',
 u'Romanian Restaurant': u'Rumano Restaurante',
 u'Roof Deck': u'La Cubierta De Techo',
 u'Rugby Pitch': u'Cancha De Rugby',
 u'Russian Restaurant': u'Restaurante Ruso',
 u'Sake Bar': u'Bar De Sake',
 u'Salad Place': u'Ensalada De Lugar',
 u'Salon / Barbershop': u'Peluquer\xeda / Barber\xeda',
 u'Salsa Club': u'Club De Salsa',
 u'Sandwich Place': u'S\xe1ndwich De Lugar',
 u'Scandinavian Restaurant': u'Escandinavos Restaurante',
 u'Scenic Lookout': u'Terraza Panor\xe1mica',
 u'School': u'La escuela',
 u'Science Museum': u'Museo De La Ciencia',
 u'Sculpture Garden': u'Jard\xedn De Las Esculturas',
 u'Seafood Restaurant': u'Restaurante De Mariscos',
 u'Shaanxi Restaurant': u'Shaanxi Restaurante',
 u'Shandong Restaurant': u'Shandong Restaurante',
 u'Shanghai Restaurant': u'Restaurante De Shanghai',
 u'Shanxi Restaurant': u'Shanxi Restaurante',
 u'Shipping Store': u'Tienda De Env\xedo',
 u'Shoe Repair': u'Reparaci\xf3n De Calzado',
 u'Shoe Store': u'Tienda De Zapatos',
 u'Shop & Service': u'Tienda Y Servicio',
 u'Shrine': u'Santuario',
 u'Skate Park': u'Parque De Skate',
 u'Skating Rink': u'Pista De Patinaje',
 u'Ski Area': u'Zona De Esqu\xed',
 u'Ski Chairlift': u'Esqu\xed En El Telesilla',
 u'Ski Chalet': u'Chalet De Esqu\xed',
 u'Ski Lodge': u'Ski Lodge',
 u'Ski Trail': u'Pista De Esqu\xed',
 u'Smoke Shop': u'El Humo De La Tienda',
 u'Smoothie Shop': u'Batido De Tienda',
 u'Snack Place': u'Merienda Lugar',
 u'Soccer Field': u'Campo De F\xfatbol',
 u'Soccer Stadium': u'Estadio De F\xfatbol',
 u'Social Club': u'Club Social',
 u'Sorority House': u'Casa De Hermandad',
 u'Soup Place': u'Sopa De Lugar',
 u'South American Restaurant': u'Am\xe9rica Del Sur Restaurante',
 u'Southeastern Brazilian Restaurant': u'Sureste Restaurante Brasile\xf1o',
 u'Southern / Soul Food Restaurant': u'Sur / Alma De Un Restaurante De Comida',
 u'Southern Brazilian Restaurant': u'El Sur De Restaurante Brasile\xf1o',
 u'Souvenir Shop': u'Tienda De Recuerdos',
 u'Souvlaki Shop': u'Souvlaki De La Tienda',
 u'Spa': u'Spa',
 u'Spanish Restaurant': u'Restaurante Espa\xf1ol',
 u'Speakeasy': u'Speakeasy',
 u'Spiritual Center': u'Centro Espiritual',
 u'Sporting Goods Shop': u'Tienda De Art\xedculos Deportivos',
 u'Sports Bar': u'Bar Deportivo',
 u'Sports Club': u'Club Deportivo',
 u'Squash Court': u'Cancha De Squash',
 u'Stables': u'Establos',
 u'Stadium': u'Estadio',
 u'State': u'Estado',
 u'States & Municipalities': u'Los Estados Y Los Municipios',
 u'Stationery Store': u'Tienda De Art\xedculos De Papeler\xeda',
 u'Steakhouse': u'Carnes',
 u'Stoop Sale': u'Rebajan La Venta',
 u'Storage Facility': u'Instalaciones De Almacenamiento',
 u'Street': u'Calle',
 u'Street Art': u'El Arte De La Calle',
 u'Street Fair': u'Calle De La Feria',
 u'Strip Club': u'Club De Striptease',
 u'Student Center': u'Centro De Estudiantes',
 u'Subway': u'Metro',
 u'Summer Camp': u'Campamento De Verano',
 u'Sundanese Restaurant': u'Sundan\xe9s Restaurante',
 u'Supermarket': u'Supermercado',
 u'Surf Spot': u'Surf Irregular',
 u'Sushi Restaurant': u'Restaurante De Sushi',
 u'Swim School': u'Escuelas De Nataci\xf3n',
 u'Swiss Restaurant': u'Restaurante Suizo',
 u'Synagogue': u'Sinagoga',
 u'Szechuan Restaurant': u'Restaurante De Szechuan',
 u'TV Station': u'Estaci\xf3n de TV',
 u'Taco Place': u'Taco Lugar',
 u'Tailor Shop': u'Tienda Del Sastre',
 u'Taiwanese Restaurant': u'Restaurante Taiwan\xe9s',
 u'Tanning Salon': u'Sal\xf3n De Bronceado',
 u'Tapas Restaurant': u'Restaurante De Tapas',
 u'Tapiocaria': u'Tapiocaria',
 u'Tatar Restaurant': u'Restaurante El T\xe1rtaro',
 u'Tattoo Parlor': u'Sal\xf3n De Tatuajes',
 u'Taxi': u'Taxi',
 u'Tea Room': u'Sal\xf3n De T\xe9',
 u'Tech Startup': u'Tech Startup',
 u'Temple': u'Templo',
 u'Tennis': u'Tenis',
 u'Tennis Court': u'Pista De Tenis',
 u'Thai Restaurant': u'Restaurante Tailand\xe9s',
 u'Theater': u'Teatro',
 u'Theme Park': u'Parque De Diversiones',
 u'Theme Park Ride / Attraction': u'Atracci\xf3n De Parque Tem\xe1tico / Atracci\xf3n',
 u'Thrift / Vintage Store': u'Segunda Mano / Tienda Vintage',
 u'Tianjin Restaurant': u'Tianjin Restaurante',
 u'Tibetan Restaurant': u'Restaurante Tibetano',
 u'Toll Booth': u'Cabina De Peaje',
 u'Toll Plaza': u'Plaza De Peaje',
 u'Tourist Information Center': u'Centro De Informaci\xf3n Tur\xedstica',
 u'Toy / Game Store': u'Juguete / Juego De Tienda',
 u'Track': u'Pista',
 u'Track Stadium': u'La Pista Del Estadio',
 u'Trade School': u'Escuela De Comercio',
 u'Trail': u'Sendero',
 u'Trailer Park': u'Trailer Park',
 u'Train': u'Tren',
 u'Train Station': u'Estaci\xf3n De Tren',
 u'Tram': u'Tranv\xeda',
 u'Travel & Transport': u'Viajes Y Transporte',
 u'Travel Agency': u'Agencia De Viajes',
 u'Travel Lounge': u'Sal\xf3n De Viaje',
 u'Tree': u'\xc1rbol',
 u'Tunnel': u'T\xfanel',
 u'Turkish Restaurant': u'Restaurante Turco',
 u'Ukrainian Restaurant': u'Restaurante Ucraniano',
 u'University': u'Universidad',
 u'Used Bookstore': u'Utiliza La Librer\xeda',
 u'Varenyky restaurant': u'Varenyky restaurante',
 u'Vegetarian / Vegan Restaurant': u'Vegetariana / Vegana Restaurante',
 u'Veterinarian': u'Veterinario',
 u'Video Game Store': u'Juego De Video De La Tienda',
 u'Video Store': u'Tienda De Video',
 u'Vietnamese Restaurant': u'Restaurante Vietnamita',
 u'Village': u'Aldea',
 u'Vineyard': u'Vi\xf1a',
 u'Volcano': u'Volc\xe1n',
 u'Volleyball Court': u'Corte De Voleibol De La',
 u'Voting Booth': u'Cabina De Votaci\xf3n',
 u'Warehouse': u'Almac\xe9n',
 u'Warehouse Store': u'Almac\xe9n De La Tienda',
 u'Watch Repair Shop': u'Ver Taller De Reparaci\xf3n',
 u'Water Park': u'Parque Del Agua',
 u'Well': u'Bien',
 u'West-Ukrainian Restaurant': u'Oeste-Restaurante Ucraniano',
 u'Whisky Bar': u'Whisky Bar',
 u'Wine Bar': u'Bar De Vinos',
 u'Wine Shop': u'Tienda De Vinos',
 u'Winery': u'Bodega',
 u'Wings Joint': u'Las Alas De La Articulaci\xf3n',
 u"Women's Store": u'La mujer de la Tienda',
 u'Xinjiang Restaurant': u'Xinjiang Restaurante',
 u'Yoga Studio': u'Estudio De Yoga',
 u'Yunnan Restaurant': u'Yunnan Restaurante',
 u'Zhejiang Restaurant': u'Zhejiang Restaurante',
 u'Zoo': u'Zoo'}
