{u'"Bagel Shop"': u'Bagel Shop',
 u'Abogado': u'Lawyer',
 u'Acai Casa': u'Acai House',
 u'Acuario': u'Aquarium',
 u'Acupunturista': u'Acupuncturist',
 u'Adultos Boutique': u'Adult Boutique',
 u'Aeropuerto': u'Airport',
 u'Aeropuerto De Tranv\xeda': u'Airport Tram',
 u'Aeropuerto Patio De Comidas': u'Airport Food Court',
 u'Afgano Restaurante': u'Afghan Restaurant',
 u'African Restaurant': u'African Restaurant',
 u'Agencia De Publicidad': u'Advertising Agency',
 u'Agencia De Reclutamiento': u'Recruiting Agency',
 u'Agencia De Viajes': u'Travel Agency',
 u'Al Aire Libre Y Recreaci\xf3n': u'Outdoors & Recreation',
 u'Al Aire Libre, Tienda De Alimentaci\xf3n': u'Outdoor Supply Store',
 u'Albergue': u'Hostel',
 u'Alb\xf3ndigas Lugar': u'Meatball Place',
 u'Aldea': u'Village',
 u'Alimentos': u'Food',
 u'Alimentos Org\xe1nicos': u'Organic Grocery',
 u'Alimentos Y Bebidas De La Tienda': u'Food & Drink Shop',
 u'Almac\xe9n': u'Warehouse',
 u'Almac\xe9n De Equipaje': u'Luggage Store',
 u'Almac\xe9n De La Tienda': u'Warehouse Store',
 u'Alquiler De Bicicletas / Bicicleta Compartir': u'Bike Rental / Bike Share',
 u'Alternativa Sanador': u'Alternative Healer',
 u'Am\xe9rica Del Sur Restaurante': u'South American Restaurant',
 u'Am\xe9rica Latina Restaurante': u'Latin American Restaurant',
 u'Anhui Restaurante': u'Anhui Restaurant',
 u'Aparcamiento': u'Parking',
 u'Apres Ski Bar': u'Apres Ski Bar',
 u'Arcade': u'Arcade',
 u'Arepa De Restaurante': u'Arepa Restaurant',
 u'Arte Y Entretenimiento': u'Arts & Entertainment',
 u'Artes Y Manualidades': u'Arts & Crafts Store',
 u'Astr\xf3logo': u'Astrologer',
 u'Atletismo Y Deportes': u'Athletics & Sports',
 u'Atracci\xf3n De Parque Tem\xe1tico / Atracci\xf3n': u'Theme Park Ride / Attraction',
 u'Auditorio': u'Auditorium',
 u'Auditorio De Colegio': u'College Auditorium',
 u'Australia Restaurante': u'Australian Restaurant',
 u'Austria Restaurante': u'Austrian Restaurant',
 u'Auto De Garaje': u'Auto Garage',
 u'Ayuntamiento': u'City Hall',
 u'BARBACOA Conjunta': u'BBQ Joint',
 u'Baiano Restaurante': u'Baiano Restaurant',
 u'Balinesa Restaurante': u'Balinese Restaurant',
 u'Baloncesto De La Universidad De La Corte': u'College Basketball Court',
 u'Banco': u'Bank',
 u'Bar': u'Bar',
 u'Bar De Buceo': u'Dive Bar',
 u'Bar De Champ\xe1n': u'Champagne Bar',
 u'Bar De C\xf3cteles': u'Cocktail Bar',
 u'Bar De Jugos': u'Juice Bar',
 u'Bar De Karaoke': u'Karaoke Bar',
 u'Bar De Playa': u'Beach Bar',
 u'Bar De Sake': u'Sake Bar',
 u'Bar De Vinos': u'Wine Bar',
 u'Bar Del Hotel': u'Hotel Bar',
 u'Bar Deportivo': u'Sports Bar',
 u'Bar Gay': u'Gay Bar',
 u'Barrio': u'Neighborhood',
 u'Base Militar': u'Military Base',
 u'Batido De Tienda': u'Smoothie Shop',
 u'Ba\xf1o De La Casa': u'Bath House',
 u'Beijing Restaurante': u'Beijing Restaurant',
 u'Betawinese Restaurante': u'Betawinese Restaurant',
 u'Biblioteca': u'Library',
 u'Biblioteca Universitaria': u'College Library',
 u'Bielorruso Restaurante': u'Belarusian Restaurant',
 u'Bien': u'Well',
 u'Bistro': u'Bistro',
 u'Blinis De La Casa': u'Blini House',
 u'Bodega': u'Winery',
 u'Bolera': u'Bowling Alley',
 u'Borek Lugar': u'Borek Place',
 u'Bosque': u'Forest',
 u'Boutique': u'Boutique',
 u'Bubble Tea Shop': u'Bubble Tea Shop',
 u'Buffet': u'Buffet',
 u'Burrito Lugar': u'Burrito Place',
 u'CAJERO autom\xe1tico': u'ATM',
 u'Cabina De Peaje': u'Toll Booth',
 u'Cabina De Votaci\xf3n': u'Voting Booth',
 u'Cafeter\xeda': u'Caf\xe9',
 u'Cafeter\xeda De La Universidad': u'College Cafeteria',
 u'Caf\xe9 Internet': u'Internet Cafe',
 u'Cajun / Restaurante Criollo': u'Cajun / Creole Restaurant',
 u'Calle': u'Street',
 u'Calle De La Feria': u'Street Fair',
 u'Cama Y Desayuno': u'Bed & Breakfast',
 u'Camboya Restaurante': u'Cambodian Restaurant',
 u'Camiones De Venta De Alimentos': u'Food Truck',
 u'Campamento De Verano': u'Summer Camp',
 u'Camping': u'Campground',
 u'Campo': u'Field',
 u'Campo De B\xe9isbol': u'Baseball Field',
 u'Campo De F\xfatbol': u'Soccer Field',
 u'Campo De F\xfatbol De La Universidad': u'College Football Field',
 u'Campo De Golf': u'Golf Course',
 u'Campo De Paintball': u'Paintball Field',
 u'Cancha De Baloncesto': u'Basketball Court',
 u'Cancha De B\xe1dminton': u'Badminton Court',
 u'Cancha De Rugby': u'Rugby Pitch',
 u'Cancha De Squash': u'Squash Court',
 u'Carnes': u'Steakhouse',
 u'Carnicero': u'Butcher',
 u'Carrera De Perros': u'Dog Run',
 u'Carretera': u'Road',
 u'Casa Club': u'Club House',
 u'Casa De Embarque': u'Boarding House',
 u'Casa De Hermandad': u'Sorority House',
 u'Casa De La Fraternidad': u'Fraternity House',
 u'Casino': u'Casino',
 u'Castillo': u'Castle',
 u'Cauc\xe1sico Restaurante': u'Caucasian Restaurant',
 u'Cementerio': u'Cemetery',
 u'Central Brasile\xf1o Restaurante': u'Central Brazilian Restaurant',
 u'Centro Cultural': u'Cultural Center',
 u'Centro De Convenciones': u'Convention Center',
 u'Centro De Distribuci\xf3n': u'Distribution Center',
 u'Centro De Estudiantes': u'Student Center',
 u'Centro De Informaci\xf3n Tur\xedstica': u'Tourist Information Center',
 u'Centro De Jardiner\xeda': u'Garden Center',
 u'Centro De La Comunidad': u'Community Center',
 u'Centro De Recreaci\xf3n': u'Recreation Center',
 u'Centro Espiritual': u'Spiritual Center',
 u'Centro M\xe9dico': u'Medical Center',
 u'Centro comercial': u'Mall',
 u'Cerrajero': u'Locksmith',
 u'Cervecer\xeda': u'Brewery',
 u'Chalet De Esqu\xed': u'Ski Chalet',
 u'Chino Arist\xf3crata Restaurante': u'Chinese Aristocrat Restaurant',
 u'Churrascaria': u'Churrascaria',
 u'Ciclo De Estudio': u'Cycle Studio',
 u'Cigkofte Lugar': u'Cigkofte Place',
 u'Cine': u'Movie Theater',
 u'Cine Independiente': u'Indie Movie Theater',
 u'Circo': u'Circus',
 u'Ciudad': u'City',
 u'Clase En La Universidad': u'College Classroom',
 u'Club De Jazz': u'Jazz Club',
 u'Club De La Comedia': u'Comedy Club',
 u'Club De Salsa': u'Salsa Club',
 u'Club De Striptease': u'Strip Club',
 u'Club Deportivo': u'Sports Club',
 u'Club Social': u'Social Club',
 u'Coche De Concesionario': u'Car Dealership',
 u'Colegio Campo De Cricket': u'College Cricket Pitch',
 u'Colegio Campo De F\xfatbol': u'College Soccer Field',
 u'Colegio De Historia De La Construcci\xf3n': u'College History Building',
 u'Colegio De Ingenier\xeda De La Construcci\xf3n': u'College Engineering Building',
 u'Colegio De Matem\xe1ticas De La Construcci\xf3n': u'College Math Building',
 u'Colegio Edificio Administrativo': u'College Administrative Building',
 u'Colegio Gimnasio': u'College Gym',
 u'College Residence Hall': u'College Residence Hall',
 u'College Y La Universidad': u'College & University',
 u'Condado': u'County',
 u'Conferencia': u'Conference',
 u'Consultorio m\xe9dico': u"Doctor's Office",
 u'Convenci\xf3n': u'Convention',
 u'Cooperativa De Cr\xe9dito': u'Credit Union',
 u'Corte De Voleibol De La': u'Volleyball Court',
 u'Creper\xeda': u'Creperie',
 u'Cricket Ground': u'Cricket Ground',
 u'De Aceh Restaurante': u'Acehnese Restaurant',
 u'De Artes Esc\xe9nicas': u'Performing Arts Venue',
 u'De Bowling Green': u'Bowling Green',
 u'De Vida Asistida': u'Assisted Living',
 u'Deli / Bodega': u'Deli / Bodega',
 u'Departamento De Almac\xe9n': u'Department Store',
 u'Desayuno Chino, Lugar': u'Chinese Breakfast Place',
 u'Desayuno Irregular': u'Breakfast Spot',
 u'Desfile': u'Parade',
 u'Dim Sum De Restaurante': u'Dim Sum Restaurant',
 u'Diner': u'Diner',
 u'Discoteca': u'Nightclub',
 u'Dispensario De Marihuana': u'Marijuana Dispensary',
 u'Doctor De Los Ojos': u'Eye Doctor',
 u'Dojo De Artes Marciales': u'Martial Arts Dojo',
 u'Dongbei Restaurante': u'Dongbei Restaurant',
 u'EV Estaci\xf3n de Carga': u'EV Charging Station',
 u'Edificio': u'Building',
 u'Edificio Acad\xe9mico De La Universidad': u'College Academic Building',
 u'Edificio Del Capitolio': u'Capitol Building',
 u'Edificio Del Gobierno': u'Government Building',
 u'Edificio Residencial (Apartamento / Condo)': u'Residential Building (Apartment / Condo)',
 u'El Arte De La Calle': u'Street Art',
 u'El Arte P\xfablico': u'Public Art',
 u'El Cruce De La Frontera': u'Border Crossing',
 u'El Desarrollo De La Vivienda': u'Housing Development',
 u'El Estadio De B\xe9isbol': u'Baseball Stadium',
 u'El Estadio De Hockey': u'Hockey Arena',
 u'El Humo De La Tienda': u'Smoke Shop',
 u'El Pastel De La Tienda': u'Pie Shop',
 u'El Pato De Pek\xedn Restaurante': u'Peking Duck Restaurant',
 u'El Pa\xeds Club De Baile': u'Country Dance Club',
 u'El Sur De Restaurante Brasile\xf1o': u'Southern Brazilian Restaurant',
 u'Embajada / Consulado De': u'Embassy / Consulate',
 u'Empada De La Casa': u'Empada House',
 u'Empanada Restaurante': u'Empanada Restaurant',
 u'En El Colegio De Teatro': u'College Theater',
 u'En barco o en Ferry': u'Boat or Ferry',
 u'Ensalada De Lugar': u'Salad Place',
 u'Entretenimiento General': u'General Entertainment',
 u'Escalada En Roca Irregular': u'Rock Climbing Spot',
 u'Escandinavos Restaurante': u'Scandinavian Restaurant',
 u'Escuela De Circo': u'Circus School',
 u'Escuela De Comercio': u'Trade School',
 u'Escuela De Conducci\xf3n': u'Driving School',
 u'Escuela De Derecho': u'Law School',
 u'Escuela De Enfermer\xeda': u'Nursery School',
 u'Escuela De Idiomas': u'Language School',
 u'Escuela De Medicina': u'Medical School',
 u'Escuela De M\xfasica': u'Music School',
 u'Escuela De Vuelo': u'Flight School',
 u'Escuela Privada': u'Private School',
 u'Escuela Secundaria': u'Middle School',
 u'Escuelas De Nataci\xf3n': u'Swim School',
 u'Escultura Al Aire Libre': u'Outdoor Sculpture',
 u'Espacio De Coworking': u'Coworking Space',
 u'Espacio Para Eventos': u'Event Space',
 u'Esqu\xed En El Telesilla': u'Ski Chairlift',
 u'Establos': u'Stables',
 u'Estaci\xf3n De Autobuses': u'Bus Station',
 u'Estaci\xf3n De Bomberos': u'Fire Station',
 u'Estaci\xf3n De Polic\xeda': u'Police Station',
 u'Estaci\xf3n De Radio': u'Radio Station',
 u'Estaci\xf3n De Tren': u'Train Station',
 u'Estaci\xf3n de TV': u'TV Station',
 u'Estadio': u'Stadium',
 u'Estadio De Baloncesto': u'Basketball Stadium',
 u'Estadio De F\xfatbol': u'Soccer Stadium',
 u'Estadio Universitario': u'College Stadium',
 u'Estado': u'State',
 u'Estofado De Restaurante': u'Hotpot Restaurant',
 u'Estudio De Danza': u'Dance Studio',
 u'Estudio De Dise\xf1o': u'Design Studio',
 u'Estudio De Grabaci\xf3n': u'Recording Studio',
 u'Estudio De Masajes A': u'Massage Studio',
 u'Estudio De Yoga': u'Yoga Studio',
 u'Et\xedope Restaurante': u'Ethiopian Restaurant',
 u'Europa Oriental Restaurante': u'Eastern European Restaurant',
 u'Europeo Moderno Restaurante': u'Modern European Restaurant',
 u'Evento': u'Event',
 u'Falafel De Restaurante': u'Falafel Restaurant',
 u'Farmacia / Farmacia': u'Drugstore / Pharmacy',
 u'Faro': u'Lighthouse',
 u'Feria': u'Fair',
 u'Festival': u'Festival',
 u'Festival De M\xfasica': u'Music Festival',
 u'Filipino Restaurante': u'Filipino Restaurant',
 u'Fish & Chips': u'Fish & Chips Shop',
 u'Fondue De Restaurante': u'Fondue Restaurant',
 u'Frutas Y Verduras De La Tienda': u'Fruit & Vegetable Store',
 u'Fujian Restaurante': u'Fujian Restaurant',
 u'Funeraria': u'Funeral Home',
 u'F\xe1brica': u'Factory',
 u'Galer\xeda De Arte': u'Art Gallery',
 u'Gastropub': u'Gastropub',
 u'General De Educaci\xf3n Y La Universidad': u'General College & University',
 u'General De Viajes': u'General Travel',
 u'Gimnasio': u'Gym',
 u'Gimnasio / Centro De Fitness': u'Gym / Fitness Center',
 u'Gimnasio De Boxeo': u'Boxing Gym',
 u'Gimnasio De Escalada': u'Climbing Gym',
 u'Gimnasio De Gimnasia': u'Gymnastics Gym',
 u'Gimnasio Piscina': u'Gym Pool',
 u'Goiano Restaurante': u'Goiano Restaurant',
 u'Golf De Disco': u'Disc Golf',
 u'Gozleme Lugar': u'Gozleme Place',
 u'Gran Caja De Tienda': u'Big Box Store',
 u'Granja': u'Farm',
 u'Guizhou Restaurante': u'Guizhou Restaurant',
 u'Hainan Restaurante': u'Hainan Restaurant',
 u'Helado De Yogurt': u'Frozen Yogurt',
 u'Henan Restaurante': u'Henan Restaurant',
 u'Hierbas Y Especias De La Tienda': u'Herbs & Spices Store',
 u'Himalaya Restaurante': u'Himalayan Restaurant',
 u'Hockey De Campo': u'Hockey Field',
 u'Hogar (privado)': u'Home (private)',
 u'Hong Kong Restaurante': u'Hong Kong Restaurant',
 u'Hookah Bar': u'Hookah Bar',
 u'Hospital': u'Hospital',
 u'Hotel': u'Hotel',
 u'Huaiyang Restaurante': u'Huaiyang Restaurant',
 u'Hubei Restaurante': u'Hubei Restaurant',
 u'Hunan Restaurant': u'Hunan Restaurant',
 u'Iglesia': u'Church',
 u'Indie Teatro': u'Indie Theater',
 u'Indonesia Restaurante': u'Indonesian Restaurant',
 u'Instalaciones De Almacenamiento': u'Storage Facility',
 u'Intersecci\xf3n': u'Intersection',
 u'Isla': u'Island',
 u'Jard\xedn': u'Garden',
 u'Jard\xedn Bot\xe1nico': u'Botanical Garden',
 u'Jard\xedn De La Cerveza': u'Beer Garden',
 u'Jard\xedn De Las Esculturas': u'Sculpture Garden',
 u'Javan\xe9s Restaurante': u'Javanese Restaurant',
 u'Jiangsu Restaurante': u'Jiangsu Restaurant',
 u'Jiangxi Restaurante': u'Jiangxi Restaurant',
 u'Jud\xedo Restaurante': u'Jewish Restaurant',
 u'Juego De Cafe': u'Gaming Cafe',
 u'Juego De Video De La Tienda': u'Video Game Store',
 u'Juguete / Juego De Tienda': u'Toy / Game Store',
 u'Kofte Lugar': u'Kofte Place',
 u'Kokore\xe7 Restaurante': u'Kokore\xe7 Restaurant',
 u'La Casa De La \xd3pera': u'Opera House',
 u'La Caza De La Oferta': u'Hunting Supply',
 u'La Comodidad De Un Restaurante De Comida': u'Comfort Food Restaurant',
 u'La Cubierta De Techo': u'Roof Deck',
 u'La Escuela Primaria': u'Elementary School',
 u'La Estaci\xf3n De Gas / Garaje': u'Gas Station / Garage',
 u'La Fotograf\xeda De Laboratorio': u'Photography Lab',
 u'La Gastronom\xeda Molecular Restaurante': u'Molecular Gastronomy Restaurant',
 u'La Junta De La Tienda': u'Board Shop',
 u'La L\xednea De Autob\xfas': u'Bus Line',
 u'La Oficina De Bienes Ra\xedces': u'Real Estate Office',
 u'La Oficina del dentista': u"Dentist's Office",
 u'La Piscina Del Hotel': u'Hotel Pool',
 u'La Pista Del Estadio': u'Track Stadium',
 u'La Salud Mental De La Oficina': u'Mental Health Office',
 u'La Tela De La Tienda': u'Fabric Shop',
 u'La Tienda De Lencer\xeda': u'Lingerie Store',
 u'La Universidad De Ciencias De La Construcci\xf3n': u'College Science Building',
 u'La Universidad De Comunicaciones De La Construcci\xf3n': u'College Communications Building',
 u'La Universidad De Hockey Sobre Patines': u'College Hockey Rink',
 u'La Universidad De La Pista': u'College Track',
 u'La Universidad De La Tecnolog\xeda De La Construcci\xf3n': u'College Technology Building',
 u'La Universidad De Las Artes De Construcci\xf3n': u'College Arts Building',
 u'La Universidad Diamante De B\xe9isbol': u'College Baseball Diamond',
 u'La Universidad Pista De Tenis': u'College Tennis Court',
 u'La Universidad Quad': u'College Quad',
 u'La Universidad Rec Center': u'College Rec Center',
 u'La Vida Nocturna Irregular': u'Nightlife Spot',
 u'La destiler\xeda': u'Distillery',
 u'La escuela': u'School',
 u'La guarder\xeda': u'Daycare',
 u'La mujer de la Tienda': u"Women's Store",
 u'Laboratorio': u'Laboratory',
 u'Laboratorio Universitario': u'College Lab',
 u'Lago': u'Lake',
 u'Las Alas De La Articulaci\xf3n': u'Wings Joint',
 u'Laser Tag': u'Laser Tag',
 u'Lavado De Coches': u'Car Wash',
 u'Lavander\xeda': u'Laundromat',
 u'Legales o financieros Servicio de': u'Financial or Legal Service',
 u'Libre de Gluten Restaurante': u'Gluten-free Restaurant',
 u'Librer\xeda': u'Bookstore',
 u'Librer\xeda De La Universidad': u'College Bookstore',
 u'Local De M\xfasica En': u'Music Venue',
 u'Los Cosm\xe9ticos De La Tienda': u'Cosmetics Shop',
 u'Los Estados Y Los Municipios': u'States & Municipalities',
 u'Los Fuegos Artificiales De La Tienda': u'Fireworks Store',
 u'Los Ni\xf1os De La Tienda': u'Kids Store',
 u'Los Pelmeni Casa': u'Pelmeni House',
 u'Los hombres de la Tienda': u"Men's Store",
 u'Lugar De Pesca': u'Fishing Spot',
 u'Lugar De Pizza': u'Pizza Place',
 u'Mac & Cheese Conjuntas': u'Mac & Cheese Joint',
 u'Macanese Restaurante': u'Macanese Restaurant',
 u'Malasia Restaurante': u'Malaysian Restaurant',
 u'Manadonese Restaurante': u'Manadonese Restaurant',
 u'Manchu Restaurante': u'Manchu Restaurant',
 u'Manti Lugar': u'Manti Place',
 u'Mercado': u'Market',
 u'Mercado De Los Agricultores': u'Farmers Market',
 u'Mercado De Navidad': u'Christmas Market',
 u'Mercado De Pescado': u'Fish Market',
 u'Mercado De Pulgas': u'Flea Market',
 u'Merienda Lugar': u'Snack Place',
 u'Metro': u'Subway',
 u'Meyhane': u'Meyhane',
 u'Mezquita': u'Mosque',
 u'Mineiro Restaurante': u'Mineiro Restaurant',
 u'Mini Golf': u'Mini Golf',
 u'Miscel\xe1nea Tienda': u'Miscellaneous Shop',
 u'Monasterio': u'Monastery',
 u'Monta\xf1a': u'Mountain',
 u'Monument / Monumento': u'Monument / Landmark',
 u'Motel': u'Motel',
 u'Muebles De Hogar / Tienda': u'Furniture / Home Store',
 u'Multiplex': u'Multiplex',
 u'Museo': u'Museum',
 u'Museo De Arte': u'Art Museum',
 u'Museo De Historia': u'History Museum',
 u'Museo De La Ciencia': u'Science Museum',
 u'Noreste Brasile\xf1o Restaurante': u'Northeastern Brazilian Restaurant',
 u'Norte Restaurante Brasile\xf1o': u'Northern Brazilian Restaurant',
 u'Nuevo Restaurante Americano': u'New American Restaurant',
 u'Objetivo En Movimiento': u'Moving Target',
 u'Oeste-Restaurante Ucraniano': u'West-Ukrainian Restaurant',
 u'Oficina': u'Office',
 u'Oficina De Correos': u'Post Office',
 u'Oficina De La Campa\xf1a': u'Campaign Office',
 u'Otro Evento': u'Other Event',
 u'Otro Taller De Reparaci\xf3n': u'Other Repair Shop',
 u'Otros Grandes Al Aire Libre': u'Other Great Outdoors',
 u'Padangnese Restaurante': u'Padangnese Restaurant',
 u'Paella Restaurante': u'Paella Restaurant',
 u'Palacio': u'Palace',
 u'Palacio de justicia': u'Courthouse',
 u'Panader\xeda': u'Bakery',
 u'Papel / Suministros De Oficina Tienda': u'Paper / Office Supplies Store',
 u'Para Preservar La Naturaleza': u'Nature Preserve',
 u'Parada De Autob\xfas': u'Bus Stop',
 u'Parque': u'Park',
 u'Parque De Diversiones': u'Theme Park',
 u'Parque De Skate': u'Skate Park',
 u'Parque Del Agua': u'Water Park',
 u'Parque Nacional': u'National Park',
 u'Parque de RV': u'RV Park',
 u'Pastelaria': u'Pastelaria',
 u'Patio De Comidas': u'Food Court',
 u'Patio de juegos': u'Playground',
 u'Pawn Shop': u'Pawn Shop',
 u'Pa\xeds': u'Country',
 u'Peluquer\xeda / Barber\xeda': u'Salon / Barbershop',
 u'Perro Caliente Conjuntas': u'Hot Dog Joint',
 u'Persa Restaurante': u'Persian Restaurant',
 u'Piano Bar': u'Piano Bar',
 u'Pide Lugar': u'Pide Place',
 u'Pier': u'Pier',
 u'Piscina': u'Pool',
 u'Pista': u'Track',
 u'Pista De Esqu\xed': u'Ski Trail',
 u'Pista De Karts': u'Go Kart Track',
 u'Pista De Patinaje': u'Skating Rink',
 u'Pista De Tenis': u'Tennis Court',
 u'Pista de carreras': u'Racetrack',
 u'Pistola De Gama': u'Gun Range',
 u'Planetario': u'Planetarium',
 u'Plano': u'Plane',
 u'Planta De Reciclaje': u'Recycling Facility',
 u'Plataforma': u'Platform',
 u'Playa': u'Beach',
 u'Playa Nudista': u'Nudist Beach',
 u'Plaza': u'Plaza',
 u'Plaza De Peaje': u'Toll Plaza',
 u'Plaza Peatonal': u'Pedestrian Plaza',
 u'Pollo Frito Conjuntas': u'Fried Chicken Joint',
 u'Postre Tienda': u'Dessert Shop',
 u'Preescolar': u'Preschool',
 u'Primavera Caliente': u'Hot Spring',
 u'Prisi\xf3n': u'Prison',
 u'Profesionales Y Otros Lugares': u'Professional & Other Places',
 u'Pub': u'Pub',
 u'Pub Irland\xe9s': u'Irish Pub',
 u'Puente': u'Bridge',
 u'Puerta De Embarque Del Aeropuerto': u'Airport Gate',
 u'Puerto / Puerto Deportivo': u'Harbor / Marina',
 u'Puesto de peri\xf3dicos': u'Newsstand',
 u'Punto De Venta De Loter\xeda': u'Lottery Retailer',
 u'Quiropr\xe1ctico': u'Chiropractor',
 u'Rafting': u'Rafting',
 u'Ramen / Noodle House': u'Ramen / Noodle House',
 u'Ravioles Restaurante': u'Dumpling Restaurant',
 u'Rebajan La Venta': u'Stoop Sale',
 u'Refugio De Animales': u'Animal Shelter',
 u'Religiosos De La Escuela': u'Religious School',
 u'Reparaci\xf3n De Calzado': u'Shoe Repair',
 u'Residencia': u'Residence',
 u'Resort': u'Resort',
 u'Restaurante': u'Restaurant',
 u'Restaurante Alem\xe1n': u'German Restaurant',
 u'Restaurante Americano': u'American Restaurant',
 u'Restaurante Argentino': u'Argentinian Restaurant',
 u'Restaurante Asi\xe1tico': u'Asian Restaurant',
 u'Restaurante Belga': u'Belgian Restaurant',
 u'Restaurante Brasile\xf1o': u'Brazilian Restaurant',
 u'Restaurante Canton\xe9s': u'Cantonese Restaurant',
 u'Restaurante Caribe\xf1o': u'Caribbean Restaurant',
 u'Restaurante Checo': u'Czech Restaurant',
 u'Restaurante Chino': u'Chinese Restaurant',
 u'Restaurante Coreano': u'Korean Restaurant',
 u'Restaurante Cubano': u'Cuban Restaurant',
 u'Restaurante De Comida Casera': u'Home Cooking Restaurant',
 u'Restaurante De Comida R\xe1pida': u'Fast Food Restaurant',
 u'Restaurante De Hamburguesas': u'Burger Joint',
 u'Restaurante De Kebab': u'Kebab Restaurant',
 u'Restaurante De Mariscos': u'Seafood Restaurant',
 u'Restaurante De Oriente': u'Middle Eastern Restaurant',
 u'Restaurante De Shanghai': u'Shanghai Restaurant',
 u'Restaurante De Sushi': u'Sushi Restaurant',
 u'Restaurante De Szechuan': u'Szechuan Restaurant',
 u'Restaurante De Tapas': u'Tapas Restaurant',
 u'Restaurante Doner': u'Doner Restaurant',
 u'Restaurante El T\xe1rtaro': u'Tatar Restaurant',
 u'Restaurante Espa\xf1ol': u'Spanish Restaurant',
 u'Restaurante Franc\xe9s': u'French Restaurant',
 u'Restaurante Griego': u'Greek Restaurant',
 u'Restaurante Hakka': u'Hakka Restaurant',
 u'Restaurante Halal': u'Halal Restaurant',
 u'Restaurante Hawaiano': u'Hawaiian Restaurant',
 u'Restaurante H\xfangaro': u'Hungarian Restaurant',
 u'Restaurante Imperial': u'Imperial Restaurant',
 u'Restaurante Indio': u'Indian Restaurant',
 u'Restaurante Ingl\xe9s': u'English Restaurant',
 u'Restaurante Italiano': u'Italian Restaurant',
 u'Restaurante Japon\xe9s': u'Japanese Restaurant',
 u'Restaurante Kosher': u'Kosher Restaurant',
 u'Restaurante Marroqu\xed': u'Moroccan Restaurant',
 u'Restaurante Mediterr\xe1neo': u'Mediterranean Restaurant',
 u'Restaurante Mexicano': u'Mexican Restaurant',
 u'Restaurante Mongol': u'Mongolian Restaurant',
 u'Restaurante Paquistan\xed': u'Pakistani Restaurant',
 u'Restaurante Peruano': u'Peruvian Restaurant',
 u'Restaurante Polaco': u'Polish Restaurant',
 u'Restaurante Portugu\xe9s': u'Portuguese Restaurant',
 u'Restaurante Ruso': u'Russian Restaurant',
 u'Restaurante Suizo': u'Swiss Restaurant',
 u'Restaurante Tailand\xe9s': u'Thai Restaurant',
 u'Restaurante Taiwan\xe9s': u'Taiwanese Restaurant',
 u'Restaurante Tibetano': u'Tibetan Restaurant',
 u'Restaurante Turco': u'Turkish Restaurant',
 u'Restaurante Ucraniano': u'Ukrainian Restaurant',
 u'Restaurante Vietnamita': u'Vietnamese Restaurant',
 u'Rock Club': u'Rock Club',
 u'Rumano Restaurante': u'Romanian Restaurant',
 u'R\xedo': u'River',
 u'Sala De Conciertos': u'Concert Hall',
 u'Sala De Conferencias': u'Conference Room',
 u'Sala De Emergencia': u'Emergency Room',
 u'Sala De Oraci\xf3n': u'Prayer Room',
 u'Sala De Reuniones': u'Meeting Room',
 u'Sala Vip En El Aeropuerto': u'Airport Lounge',
 u'Sal\xf3n': u'Lounge',
 u'Sal\xf3n De Billar': u'Pool Hall',
 u'Sal\xf3n De Bronceado': u'Tanning Salon',
 u'Sal\xf3n De Perforaci\xf3n': u'Piercing Parlor',
 u'Sal\xf3n De Tatuajes': u'Tattoo Parlor',
 u'Sal\xf3n De T\xe9': u'Tea Room',
 u'Sal\xf3n De U\xf1as': u'Nail Salon',
 u'Sal\xf3n De Viaje': u'Travel Lounge',
 u'Santuario': u'Shrine',
 u'Segunda Mano / Tienda Vintage': u'Thrift / Vintage Store',
 u'Sendero': u'Trail',
 u'Servicio De Cambio De Cheques': u'Check Cashing Service',
 u'Servicio De Lavander\xeda': u'Laundry Service',
 u'Servicio De Mascotas': u'Pet Service',
 u'Servicios de TI': u'IT Services',
 u'Shaanxi Restaurante': u'Shaanxi Restaurant',
 u'Shandong Restaurante': u'Shandong Restaurant',
 u'Shanxi Restaurante': u'Shanxi Restaurant',
 u'Sin Fines De Lucro': u'Non-Profit',
 u'Sinagoga': u'Synagogue',
 u'Sitio De Buceo': u'Dive Spot',
 u'Sitio Hist\xf3rico': u'Historic Site',
 u'Ski Lodge': u'Ski Lodge',
 u'Sopa De Lugar': u'Soup Place',
 u'Souvlaki De La Tienda': u'Souvlaki Shop',
 u'Spa': u'Spa',
 u'Speakeasy': u'Speakeasy',
 u'Sundan\xe9s Restaurante': u'Sundanese Restaurant',
 u'Supermercado': u'Supermarket',
 u'Sur / Alma De Un Restaurante De Comida': u'Southern / Soul Food Restaurant',
 u'Sureste Restaurante Brasile\xf1o': u'Southeastern Brazilian Restaurant',
 u'Surf Irregular': u'Surf Spot',
 u'S\xe1ndwich De Lugar': u'Sandwich Place',
 u'Taco Lugar': u'Taco Place',
 u'Tapiocaria': u'Tapiocaria',
 u'Taxi': u'Taxi',
 u'Teatro': u'Theater',
 u'Tech Startup': u'Tech Startup',
 u'Tejido De Punto De La Tienda': u'Knitting Store',
 u'Telef\xe9rico': u'Cable Car',
 u'Templo': u'Temple',
 u'Templo Budista': u'Buddhist Temple',
 u'Templo Hind\xfa': u'Hindu Temple',
 u'Tenis': u'Tennis',
 u'Terminal Del Aeropuerto': u'Airport Terminal',
 u'Terraza Panor\xe1mica': u'Scenic Lookout',
 u'Tianjin Restaurante': u'Tianjin Restaurant',
 u'Tienda Automotriz': u'Automotive Shop',
 u'Tienda De Accesorios': u'Accessories Store',
 u'Tienda De Alfombras': u'Carpet Store',
 u'Tienda De Alimentos Saludables': u'Health Food Store',
 u'Tienda De Antig\xfcedades': u'Antique Shop',
 u'Tienda De Apuestas': u'Betting Shop',
 u'Tienda De Armas': u'Gun Shop',
 u'Tienda De Art\xedculos De Cuero': u'Leather Goods Store',
 u'Tienda De Art\xedculos De Papeler\xeda': u'Stationery Store',
 u'Tienda De Art\xedculos Deportivos': u'Sporting Goods Shop',
 u'Tienda De Beb\xe9': u'Baby Store',
 u'Tienda De Bicicletas': u'Bike Shop',
 u'Tienda De Buceo': u'Dive Shop',
 u'Tienda De Cerveza': u'Beer Store',
 u'Tienda De Chocolate': u'Chocolate Shop',
 u'Tienda De Colchones': u'Mattress Store',
 u'Tienda De Comestibles': u'Grocery Store',
 u'Tienda De Conveniencia': u'Convenience Store',
 u'Tienda De Cupcake': u'Cupcake Shop',
 u'Tienda De C\xe1maras': u'Camera Store',
 u'Tienda De C\xf3mics': u'Comic Shop',
 u'Tienda De Descuento': u'Discount Store',
 u'Tienda De Discos': u'Record Shop',
 u'Tienda De Disfraces': u'Costume Shop',
 u'Tienda De Donuts': u'Donut Shop',
 u'Tienda De Dulces': u'Candy Store',
 u'Tienda De Electr\xf3nica': u'Electronics Store',
 u'Tienda De Env\xedo': u'Shipping Store',
 u'Tienda De Flores': u'Flower Shop',
 u'Tienda De Hardware': u'Hardware Store',
 u'Tienda De Helados': u'Ice Cream Shop',
 u'Tienda De Impresi\xf3n': u'Print Shop',
 u'Tienda De Joyas': u'Jewelry Store',
 u'Tienda De Licores': u'Liquor Store',
 u'Tienda De Marcos': u'Frame Store',
 u'Tienda De Mascotas': u'Pet Store',
 u'Tienda De Modelismo': u'Hobby Shop',
 u'Tienda De Motos': u'Motorcycle Shop',
 u'Tienda De M\xfasica': u'Music Store',
 u'Tienda De Perfumes': u'Perfume Shop',
 u'Tienda De Pesca': u'Fishing Store',
 u'Tienda De Quesos': u'Cheese Shop',
 u'Tienda De Recuerdos': u'Souvenir Shop',
 u'Tienda De Regalos': u'Gift Shop',
 u'Tienda De Ropa': u'Clothing Store',
 u'Tienda De Telefon\xeda M\xf3vil': u'Mobile Phone Shop',
 u'Tienda De Video': u'Video Store',
 u'Tienda De Vinos': u'Wine Shop',
 u'Tienda De Zapatos': u'Shoe Store',
 u'Tienda Del Sastre': u'Tailor Shop',
 u'Tienda Gourmet': u'Gourmet Shop',
 u'Tienda Nupcial': u'Bridal Shop',
 u'Tienda Outlet': u'Outlet Store',
 u'Tienda Pop-Up': u'Pop-Up Shop',
 u'Tienda Y Servicio': u'Shop & Service',
 u'Tienda \xd3ptica': u'Optical Shop',
 u'Tintorer\xeda': u'Dry Cleaner',
 u'Trailer Park': u'Trailer Park',
 u'Tranv\xeda': u'Tram',
 u'Tren': u'Train',
 u'Tren Ligero': u'Light Rail',
 u'T\xfanel': u'Tunnel',
 u'Ubicaci\xf3n De Coches De Alquiler': u'Rental Car Location',
 u'Universidad': u'University',
 u'Universidad De Comunidad': u'Community College',
 u'Utiliza La Librer\xeda': u'Used Bookstore',
 u'Varenyky restaurante': u'Varenyky restaurant',
 u'Vegetariana / Vegana Restaurante': u'Vegetarian / Vegan Restaurant',
 u'Ver Taller De Reparaci\xf3n': u'Watch Repair Shop',
 u'Veterinario': u'Veterinarian',
 u'Viajes Y Transporte': u'Travel & Transport',
 u'Vida Nocturna': u'Other Nightlife',
 u'Vi\xf1a': u'Vineyard',
 u'Volc\xe1n': u'Volcano',
 u'Whisky Bar': u'Whisky Bar',
 u'Xinjiang Restaurante': u'Xinjiang Restaurant',
 u'Yunnan Restaurante': u'Yunnan Restaurant',
 u'Zhejiang Restaurante': u'Zhejiang Restaurant',
 u'Zona De Ba\xf1o': u'Bathing Area',
 u'Zona De Esqu\xed': u'Ski Area',
 u'Zoo': u'Zoo',
 u'\xc1rbol': u'Tree',
 u'\xc1rea De Descanso': u'Rest Area'}
